100000000000
100000000000
100000111110
100000100000
100000100000
100000000000
100000000000
100000111110
100000101010
100000101010
100000000000
100000011110
100000100000
100000011110
100000000000
100000111110
100000101010
100000101010
100000000000
100000111110
100000100000
100000100000
100000000000
100000000000
100000000000
100000000000
100000100100
100000111110
100000100000
100000000000
100000000000
100000000000
100000000000
100111111111
100000000000
100000000000
111001111111
100000000000
100000000000
111110011111
100000000000
100000000000
100000000000
100000000000
111110011111
100000000000
100000000000
111001111111
100000000000
100000000000
100111111111
100000000000
100000000000
100000000000
100000000000
110000111111
111000011111
111100001111
111110000111
111111000011
111111100001
100000000000
100000000000
100000000000
100000000000
100000000000
100000000000
100000000000
100100000000
100100000000
100100000000
100100000000
100001000000
100001000000
100001000000
100001000000
100000010000
100000010000
100000010000
111111110000
000000000000
100000000000
100000000000
100000000000
100000000000
000000000000
001000000000
001000000000
001000000000
001000000000
000000000000
000010000000
000010000000
000010000000
000010000000
000000000000
000000100000
000000100000
000000100000
000000100000
111111100000
000000000000
100000000000
100000000000
000000000000
001000000000
001000000000
000000000000
000010000000
000010000000
000000000000
000000100001
000000100001
000000100001
000000100001
000000100001
100000000001 2:120:0:1
000000100001
000000100001
000000100001
000000100001
000000100001
100000000001 2:120:0:1
100000000001 2:120:0:1
100000000001 2:120:0:1
100000100001
100000100001
100000100001
100000100001
100000000001 2:120:0:1
100000000001 2:120:0:1
100000000001 2:120:0:1
100000000001 2:120:0:1
100000000001 2:120:0:1
111101100001 2:120:0:1
100000100001
100000100001
100000100001 2:120:0:1
100000000001
100000000001
100000000001
100000000001
100000000001
100000000001
100000000001
100000000001
100000000001
100000000001
100000000001
100000000001
100000000001
010000000010
001000000100
000100001000
000010010000
000010010000
000010010000
000010010000
000010010000
000010010000
000010010000
000010010000
000010010000
000010010000
000010010000
000010010000
000010010000
000010010000
000010010000
000010010000
000010010000
000010010000
000010010000
000010010000
000010010000
000010010000
000010010000
000010010000
000010010000
000010010000
000010010000
000010010000
000010010000
000010010000
000010010000
000010010000
000010010000
000010010000
000011110000
000000000000
000000000000
