100000000001
100000000101
100001111101
100000000101
100000000001
100001111101
100001000001
100001111101
100000000001
100000000101
100001111101
100000000101
100000000001
100001111101
100001000101
100001111101
100000000001
100001111101
100000010101
100001101001
100000000001
100001000101
100001111101
100001000101
100000000001
100001111001
100000010101
100001111001
100000000001
100001111101
100001000001
100001000001
100000000001
100000000001
100000000001
111100000001
111111110001
100000000001
101111111111
100000000001
100000000001
100000000001
100000000001
100010000001 2:50:0:4
100010000001 2:50:0:4
100010000001 2:50:0:4
100010000001 2:50:0:4
100010000001 2:50:0:4
100010000001 2:50:0:4
100000000001
100000000001
100000000001
100000000001
100000000001
100000000001
100000000001
100000000001
100000000001
100000000001
100000000001
100011110001
100000000001
100000000001
100000000001
100000000001
100000001001
100000001001
100000001001
100000001001 3:300:-3:20
100000001111
100000000001
100000000001
100000000001
100000000001
100000000001
100000000001
100000000001
100000000001
100000000001
100000000001
100000000001
100000000001
100000000001
100000000001
100000000001
100000000001
100000000001
100001111101
100001010101
100001010101
100000000001
100001111101
100000001001
100000010001
100001111101
100000000001
100001111101
100001000101
100000111001
100000000001
111111111111
000000000000