100000000000
100000000000
100000111110
100000100000
100000100000
100000000000
100000111110
100000101010
100000101010
100000000000
100000011110
100000100000
100000011110
100000000000
100000111110
100000101010
100000101010
100000000000
100000111110
100000100000
100000100000
100000000000
100000000000
100000000000
100000000000
100000111010
100000101010
100000101110
100000000000
100000000000
100000000000
100000000000
100000000000
100000000000
111000000000
111100000000
110110000000
100010000000
110110000000
111100001000
111000011111
111100001000
110110000000
100010000000
110110000000
111100010000
111000111111
111100010000
110110000000
100010000000
110110000000
111100100000
111001111111
111100100000
110110000000
100010000000
110110000000
111110000000
100010000000
101010111111
101010100001
101010101101
101010001101
101011111101
101000000001
101111111111
101111111111
100000000000
100000000000
101111111111
101111111111
100000000000
111100000000
000000000000
000000000000
000000000000
000000000000
000000000000
000000000000
100000000000
100100000000 2:30:0:1
100000000000
000000000000
000000000000
000000000000
000000000000
000000000000
000000000000
100000000000
100100000000 2:30:0:1
100000000000
000000000000
000000000000
000000000000
000000000000
000000000000
000000000000
100000000000
100000000000
100000000000
100000000000
100000000000
100000000000
100000000001 2:30:0:6
100000000001 2:30:0:6
100000000001 2:30:0:6
100000000001 2:30:0:6
100000000001 2:30:0:6
100000000001 2:30:0:6
100000000001 2:30:0:6
100000000001 2:30:0:6
100000000001 2:30:0:6
100000000111 2:30:0:6
100000000100 2:30:0:6
100000000100 2:30:0:6
100000000100 2:30:0:6
100000000100 2:30:0:6
100000000100 2:30:0:6
100000000100 2:30:0:6
100000000100 2:30:0:6
100000000100 2:30:0:6
100000011100 2:30:0:6
100000010000 2:30:0:6
100000010000 2:30:0:6
100000010000 2:30:0:6
100000010000 2:30:0:6
100000010000 2:30:0:6
100000010000 2:30:0:6
100000010000 2:30:0:6
100000010000 2:30:0:6
100001110000 2:60:0:0
100001000000 2:30:0:3
100001000000 2:30:0:3
100001000000 2:30:0:3
100001000000 2:30:0:3
100001000000 2:30:0:3
100001000000 2:30:0:3
100001000000 2:30:0:3
100001000000 2:30:0:3
100001000000 2:30:0:3
100111000000
100100000000
100100000000 2:30:0:1
100100000000 2:30:0:1
100100000000 2:30:0:1
100100000000 2:30:0:1
100100000000 2:30:0:1
100100000000 2:30:0:1
100100000000 2:30:0:1
100100000000 2:30:0:1
100100000000 2:30:0:1
100100000000 2:30:0:1
100100000000 2:30:0:1
100111111111 2:30:0:1
100000000001
100000000001
100000000001
100000000001
100000000001
100000000001
110000000001
111000000001
111100000001
111110000001
111111000001
111111100001
111111110001
111111111001
100000000001
101110001111
101000000001
101011110001
101010000001
101010000001
101010000001
101010000001
101010000001
101010000001
101010000001
101010000001
101010000001
101010000001
101010000001
101010000001
111011111111
001010000000
001010000000
001010000000
001010000000
001010000000
001010000000
001010000000
001010000000
001010000000
001010000000
001010000000
001010000000
001010000000
001010000000
001010000000
001010000000
001010000000
001010000000
001010000000
001010000000
001010000000
001010000000
001010000000
001010000000
001010000000
001010000000
001010000000
001010000000
001010000000
001110000000
000000000000
000000000000