100000000000
100000000000
100000111110
100000100000
100000100000
100000000000
100000111110
100000101010
100000101010
100000000000
100000011110
100000100000
100000011110
100000000000
100000111110
100000101010
100000101010
100000000000
100000111110
100000100000
100000100000
100000000000
100000000000
100000000000
100000000000
100000101010
100000101010
100000111110
100000000000
100000000000
100000000000
100000000000
100000000000
100000000000
100000000000
100000000000
100000000000
100000000000
100000000000
100000000000
100000000000
100000000000
100000000000
100000000000
100000000000
100000000000
100000000000
100000000001
100000000001
100000000001
100000000001 2:180:-1:3 2:180:-1:-3
100000000001
100000000001 2:180:0:3 2:180:0:-3
100000000001
100000000001 2:180:-1:3 2:180:-1:-3
100000000001
100000000001 2:180:0:3 2:180:0:-3
100000000001
100000000001 2:180:-1:3 2:180:-1:-3
100000000001
100110011001 2:45:0:1 2:165:0:1 2:285:0:1
100000000001
100000000001
100000000001 2:180:-3:3 2:180:-3:-3
100000000001
100000000001
100110011001 2:45:0:1 2:165:0:1 2:285:0:1 3:45:-1:20
100000000001
100000000001
100000000001
100000000001
100000000001
100000000001
100000000001
100000000001
100110011001 2:45:0:1 2:165:0:1 2:285:0:1
100000000001
100000000001
100000000001 2:180:-3:3 2:180:-3:-3
100000000001
100000000001
100110011001 2:45:0:1 2:165:0:1 2:285:0:1 3:45:-1:20
100000000001
100000000001
100000000001
100000000001
100000000001
100000000001
100000000001
100000000001
100110011001
100000000001 2:165:0:4
010000000010 2:165:0:3
001000000100 2:165:0:2
000100001000 2:165:0:1
000010010000
000010010000
000010010000 2:165:0:1
000010010000 2:165:0:1
000010010000 2:165:0:1
000010010000 2:165:0:1
000010010000 2:165:0:1
000010010000 2:165:0:1
000010010000 2:165:0:1
000010010000 2:165:0:1
000010110000
000010100000
000010100000
000010100000
000010100000
000010100000
000010100000
000010100000
000010100000
000010100000
000010100000
000010100000
000010100000
000010100000
000010100000
000010100000
000010100000
000010100000
000010100000
000010100000
000010100000
000010100000
000010100000
000010100000
000010100000
000010100000
000011100000
000000000000